0411120000
0100010000
0100010000
0109010000
0511130000
0001000000
0001111200
0113000100
0000090100
0005111300
